# map for ssd of MPR circuit
# [category] [id] [[device] [focus] [detector] [module] [ch]] ....
#
# for telescope 1 dEa X
# Map: energy, timing
#
#--------------------------------------------------------------------
10, 0,  12 1  6   3  0,  12 2  7  0  16 
10, 1,  12 1  6   3  1,  12 2  7  0  17 
10, 2,  12 1  6   3  2,  12 2  7  0  18 
10, 3,  12 1  6   3  3,  12 2  7  0  19 
10, 4,  12 1  6   3  4,  12 2  7  0  20 
10, 5,  12 1  6   3  5,  12 2  7  0  21 
10, 6,  12 1  6   3  6,  12 2  7  0  22 
10, 7,  12 1  6   3  7,  12 2  7  0  23 
10, 8,  12 1  6   3  8,  12 2  7  0  24 
10, 9,  12 1  6   3  9,  12 2  7  0  25 
10, 10, 12 1  6   3  10, 12 2  7  0  26 
10, 11, 12 1  6   3  11, 12 2  7  0  27 
10, 12, 12 1  6   3  12, 12 2  7  0  28 
10, 13, 12 1  6   3  13, 12 2  7  0  29 
10, 14, 12 1  6   3  14, 12 2  7  0  30 
10, 15, 12 1  6   3  15, 12 2  7  0  31 
