# map for ssd of MPR
# [category] [id] [[device] [focus] [detector] [module] [ch]] ....
#
# for telescope 1 dEa Y
# Map: energy, timing
#
#--------------------------------------------------------------------
11, 0,  12 1  6   3  16,  12 2  7   0  32
11, 1,  12 1  6   3  17,  12 2  7   0  33
11, 2,  12 1  6   3  18,  12 2  7   0  34
11, 3,  12 1  6   3  19,  12 2  7   0  35
11, 4,  12 1  6   3  20,  12 2  7   0  36
11, 5,  12 1  6   3  21,  12 2  7   0  37
11, 6,  12 1  6   3  22,  12 2  7   0  38
11, 7,  12 1  6   3  23,  12 2  7   0  39
11, 8,  12 1  6   3  24,  12 2  7   0  40
11, 9,  12 1  6   3  25,  12 2  7   0  41
11, 10, 12 1  6   3  26,  12 2  7   0  42
11, 11, 12 1  6   3  27,  12 2  7   0  43
11, 12, 12 1  6   3  28,  12 2  7   0  44
11, 13, 12 1  6   3  29,  12 2  7   0  45
11, 14, 12 1  6   3  30,  12 2  7   0  46
11, 15, 12 1  6   3  31,  12 2  7   0  47
