# map for ssd of old circuit
# [category] [id] [[device] [focus] [detector] [module] [ch]] ....
#
# for telescope 2 dEa X
# Map: energy, timing
#
#--------------------------------------------------------------------
20, 15,  12 1  6   1  0,  12 2  7  0  48 
20, 14,  12 1  6   1  1,  12 2  7  0  49 
20, 13,  12 1  6   1  2,  12 2  7  0  50 
20, 12,  12 1  6   1  3,  12 2  7  0  51 
20, 11,  12 1  6   1  4,  12 2  7  0  52 
20, 10,  12 1  6   1  5,  12 2  7  0  53 
20, 9,  12 1  6   1  6,  12 2  7  0  54 
20, 8,  12 1  6   1  7,  12 2  7  0  55 
20, 7,  12 1  6   1  8,  12 2  7  0  56 
20, 6,  12 1  6   1  9,  12 2  7  0  57 
20, 5, 12 1  6   1  10, 12 2  7  0  58 
20, 4, 12 1  6   1  11, 12 2  7  0  59 
20, 3, 12 1  6   1  12, 12 2  7  0  60 
20, 2, 12 1  6   1  13, 12 2  7  0  61 
20, 1, 12 1  6   1  14, 12 2  7  0  62 
20, 0, 12 1  6   1  15, 12 2  7  0  63 
