# map for ssd of old circuit
# [category] [id] [[device] [focus] [detector] [module] [ch]] ....
#
# for telescope 2 dEa Y only energy
# Map: energy, timing
#
#--------------------------------------------------------------------
21, 15,  12 1  6   1  16,  12 2  7   1  16
21, 14,  12 1  6   1  17,  12 2  7   1  17
21, 13,  12 1  6   1  18,  12 2  7   1  18
21, 12,  12 1  6   1  19,  12 2  7   1  19
21, 11,  12 1  6   1  20,  12 2  7   1  20
21, 10,  12 1  6   1  21,  12 2  7   1  21
21, 9,  12 1  6   1  22,  12 2  7   1  22
21, 8,  12 1  6   1  23,  12 2  7   1  23
21, 0,  12 1  6   1  24,  12 2  7   1  24
21, 1,  12 1  6   1  25,  12 2  7   1  25
21, 2, 12 1  6   1  26,  12 2  7   1  26
21, 3, 12 1  6   1  27,  12 2  7   1  27
21, 4, 12 1  6   1  28,  12 2  7   1  28
21, 5, 12 1  6   1  29,  12 2  7   1  29
21, 6, 12 1  6   1  30,  12 2  7   1  30
21, 7, 12 1  6   1  31,  12 2  7   1  31
