# map for ssd of old circuit
# [category] [id] [[device] [focus] [detector] [module] [ch]] ....
#
# for telescope 3 dEa Y only energy
# Map: energy, timing
#
#--------------------------------------------------------------------
31, 15,  12 1  6   2  16,  12 2  7   0  96
31, 14,  12 1  6   2  17,  12 2  7   0  97
31, 13,  12 1  6   2  18,  12 2  7   0  98
31, 12,  12 1  6   2  19,  12 2  7   0  99
31, 11,  12 1  6   2  20,  12 2  7   0  100
31, 10,  12 1  6   2  21,  12 2  7   0  101
31, 9,  12 1  6   2  22,  12 2  7   0  102
31, 8,  12 1  6   2  23,  12 2  7   0  103
31, 0,  12 1  6   2  24,  12 2  7   0  104
31, 1,  12 1  6   2  25,  12 2  7   0  105
31, 2, 12 1  6   2  26,  12 2  7   0  106
31, 3, 12 1  6   2  27,  12 2  7   0  107
31, 4, 12 1  6   2  28,  12 2  7   0  108
31, 5, 12 1  6   2  29,  12 2  7   0  109
31, 6, 12 1  6   2  30,  12 2  7   0  110
31, 7, 12 1  6   2  31,  12 2  7   0  111
