# map for ssd of old circuit
# [category] [id] [[device] [focus] [detector] [module] [ch]] ....
#
# for telescope 3 dEa X
# Map: energy, timing
#
#--------------------------------------------------------------------
30, 0,  12 1  6   2  0,  12 2  7  0  80 
30, 1,  12 1  6   2  1,  12 2  7  0  81 
30, 2,  12 1  6   2  2,  12 2  7  0  82 
30, 3,  12 1  6   2  3,  12 2  7  0  83 
30, 4,  12 1  6   2  4,  12 2  7  0  84 
30, 5,  12 1  6   2  5,  12 2  7  0  85 
30, 6,  12 1  6   2  6,  12 2  7  0  86 
30, 7,  12 1  6   2  7,  12 2  7  0  87 
30, 8,  12 1  6   2  8,  12 2  7  0  88 
30, 9,  12 1  6   2  9,  12 2  7  0  89 
30, 10, 12 1  6   2  10, 12 2  7  0  90 
30, 11, 12 1  6   2  11, 12 2  7  0  91 
30, 12, 12 1  6   2  12, 12 2  7  0  92 
30, 13, 12 1  6   2  13, 12 2  7  0  93 
30, 14, 12 1  6   2  14, 12 2  7  0  94 
30, 15, 12 1  6   2  15, 12 2  7  0  95 
